Created;Accepted;InWork;Delegated;Completed;Discarded;Total
5;0;0;0;0;0;5
7;0;0;3;0;1;11
7;0;1;7;0;1;16
8;0;5;11;0;1;25
5;0;4;15;3;2;29
3;0;5;15;9;3;35
2;0;3;14;13;3;35
1;0;2;7;22;3;35
1;0;2;6;23;3;35
0;0;2;6;24;3;35
